R 1080 720
NO ./assets/wolf3d/greystone.XPM
SO ./assets/wolf3d/redbrick.XPM
EA ./assets/wolf3d/purplestone.XPM
WE ./assets/wolf3d/eagle.XPM
S ./wolftex/textures/xpm/barrel.xpm
C 255,200,160
F 122,122,122

11111111111111111
10000000000000001
10000000000000001
10000000000000001
10000000000000001
10000000000000001
10000000P00000001
10000000000000001
10000000000000001
10000000000000001
10000000000000001
10000000000000001
11111111111111111
